11111111111
10000300001
10000000001
10000000001
10000000001
10000000001
10000000001
10000000001
10000000001
10000200001
11111111111