11111111111
10001310001
10001010001
10001010001
11111011111
14000000041
11111011111
10001010001
10001010001
10001210001
11111111111